arreglar el dormitorio: to straighten up the room
tender [ie] la cama: to make the bed
hacer la cama: to do the bed
colgar [ue] la ropa en el armario: to hang up the clothes in the closet
barrer el piso: to sweep the floor
recoger los periódicos: to pick up the newspapers
colocar los libros en el estante: to place the books in the bookcase
vaciar el cesto de papeles: to empty the wastebasket
vaciar los ceniceros: to empty the ashtray
pasar la aspiradora: to vacuum
sacudir los alfombras: to shake the carpets
quitar el polvo de los muebles: to dust the furniture
poner la mesa: to set the table
recoger la mesa: to clear the table
lavar los legumbres: to wash the legumes
pelar las papas: to peel the potatoes
cortar el pan: to cut the bread
limpiar el fregadero: to clean the sink
fregar [ie] los platos: to wash the dishes
lavar los platos: to wash the dishes
secar los platos: to dry the dishes
sacar la basura: to take out the trash
lavar las sábanas: to wash the sheets
secar los calcetines: to dry the socks
planchar las camisas: to iron the shirts
plantar los flores: to plant the flowers
regar [ie] las plantas: to water the plants
la hierba: the grass
el césped: the lawn
cuidar a los animals: to take care of the animals
sacar a pasear al perro: to walk the dog
darle de comer al gato: to feed the cat
un trapo: rag
una escoba: broomstick
una percha: hanger
una plancha: iron
una aspiradora: vacuum
una manguera: hose
una cortadora de césped: lawnmower
una máquina de lavar: washing machine
una lavadora de ropa: washing machine
una máquina de secar: dryer
una secadora de ropa: dryer
un lavaplatos: dishwasher
una lavadora de platos: dishwasher
¿Me puede?: can you
¿Me podría?: could you
ayudar: help me
dar una mano: give me a hand
echar una mano: lend me a hand
hacer un favor: do me a favor
Sí, con mucho gusto: Yes, with pleasure
Encantado(a). ¿En qué puedo servirle?: Delighted, how can I serve you?
No, de veras, no puedo: No, really, I can't
Mira, me gustaría, pero: Look, I'd like to, but
Quisiera, pero: I would like to, but
Lo siento mucho, pero: Sorry, but
Perdónme, pero: Excuse me, but
¡Qué lástima!, pero: What a shame, but
estoy ocupadísimo(a): I'm very busy
estoy cansado(a): I'm tired
estoy rendido(a): I'm exhausted
no tengo tiempo: I don't have time
tengo otras cosas que hacer: I have other things to do
me es imposible: It's impossible for me
¡Se lo agradezco mucho!: I really appreciate it
No hay de qué: Don't mention it
Para servirle: At your service


